%%%%%%%%%%%%%%%%%%%%
%......%G  G%......%
%.  ...%%  %%...  .%
%. .. ........ .. .%
%.  . .      . .  .%
%..................%
%%%%%%%%%%%%%%%%%%%%
