%%%%%
%G.G%
%. .%
% . %
%. .%
% . %
%. .%
% . %
%P .%
%%%%%